6
7
1001****111001
0110****011001
0110******1001
1110******1111
****000001****
****100001****
000110**0111**
011111**1110**
01111111111000
11100000011001
1110******1001
0111******0001
