4
3
******
******
**00**
**10**
**10**
**00**
******
******
