4
7
10000111100001
11111001111000
1111********00
0001********11
0001********11
1110********01
11100110000001
11111110000111
