9
16
11100000011001111001111000011111
00011001111000011111100000011001
00011001111000011111100000011001
01111111111110000000011001111000
01111111******000000011001111000
11100000******011001111001111000
11100000******011001111001111000
00000000******111111111110000000
00000000000111111111111110000000
00000000011111111110000001111001
00000000011111111110****01111001
00011001111110000110****11100000
00011001**1110000110****11100000
00011001**0000000000****11111111
00011001****00000000011111111111
01111000****00000001111110000000
01111000******000001111110000000
00000000******000000000000000000
