5
5
1111111111
1000000111
100000**11
000110**00
**01**1000
**00**0000
**0001**00
**1111**11
0111111111
1110000111
